##################################################
#..~~~~..........................................#
#..~~~~..........................................#
#...~~~~.........................................#
#....~~~~~~~~~~~~~~..............................#
#......~~~~~~~~~~~~~~==~~~.......................#
#.................~~~==~~~~~.....................#
#........................~~~~....................#
#.........................~~~~...................#
#.........................~~~~...................#
#..........................~~~~~~~~~~~~~~~~......#
#............................~~~~~~~~~~~~~~~~....#
#.........................................~~~~...#
#..........................................~~~~..#
##################################################
